#######################
#.@.#.................#
#...#.................#
#...#.................|
#.###.................#
#.....................#
#.....................#
#.....................#
#.....................#
#.....................#
#.....................#
#.....................#
#######################