	      _
	     | |
 #############_#######
#.@.#.................#
#...#.................#####
#...#................./   #
#.###.................#####
#.....................[
#.....................#++++
#.....................()  +
#.....................#++++
 #...................#
  ###################