#######################
#...#.................#
#...#.................#
#...#.................#
#####.................#
()@...................#
#.....................#
#.....................#
#.....................#
#.....................#
#.....................#
#.....................#
#######################