	      _
	     | |
##############_#######
].@.#.................#
#...#.................##
#...#................./#
#.###.................##
#.....................#
#.....................#++
#.....................\ +
#.....................#++
 #...................##
  #####################

	LEVEL 2