 #####################
#]@#####..####.#.#..###
#.......#....#...#.####
#.###.#.#.#.##.#...#..[
#####.#...#....##.###.#
#.....#.#....####...#.#
#.###...##.#.#....##..#
#....###...#.##.#....##
#.##.#.###.#....#.##.##
 ###.......#.####.#..#
  ###################
		ARTUR 2 