#######################
#...#.................#
#...#.................#
#...#.................#
#####.................#
#.....................#
#.....................#
#.....................#
#.....................#
#.....................#
#.....................#
#..........@..........#
###########_###########