	      _
	     | |
 #############_#######
#.@.#.................#
#...#.................#####
#...#................./   #
#.###.................#####
#.....###.............[
#......Q#.....#Q#......#++++
#.....###.............()  +
#.....................#++++
 #...................#
  ###################