DAVID 4    ##
"TANK"    #..####
         #..Q....[###############
         #......#
   #################
 ##.................#
#]@.................Q#
 #.#.#.#.#..#.#.#.#.#
  ##################