################### DAVID 5
#]@..#......###...# 
##.#.#.#.####.#.#.#
 #.#...#..#...#.#$#
 #.####.#.#.##...##
 #.#..#.#.#.####.##
 #...#....#....#.##
 #.#.#.#..##.#.#.##
 #.##..#.###.#.#.##
 #.####..#...#....#
 #....##.#.########
 #.#...#....#.....#
 #####.####.#.#.#.#
 #...#....#...#.#.#
 #.#.####.#.#####.##
 #$#......#.....#.[#
 ###################