          #
         ##	 DAVID 3
      ####  "Dragon"
     #]@..#          #
    #.....#         ##
    #.###Q#  #######.#
#    # #.# #.#..#.#.#
## #    #.##......#.#
#Q#.####...........#
#.#.......#....#..#
#......#..#....##.#
#...#..#...####  ###
#...#####.#
#.##    #.#
 #      #.#
        #.#
       #..#
       #.#
     ##..#
    #..#.[#
     ## ##