      #####################
     #].#####..####.#.#..###
     #.......#....#...#.####
     #.###.#.#.#.##.#...#..[
     #####.#...#....##.###.#
     #.....#.#....####...#.#
     #.###...##.#.#....##..#
     #....###...#.##.#....##
     #$##.#.###.#....#.##.##
      ###.......#.####.#$.#
       ###################
               ARTUR 2 