 ############################
##.#...##...######...#.......#
##...#..##.##...#..#...#..#.##
##.####..#.#..#.##...#...##.##
##.#####.....##....#...#.##.##
##.########################.##
#@.............Q#Q...........[
##.########################.##
##.#######...##....#.#.#.##.##
##.#######.#.##.#.........#.##
##...#...#.#.##.##.#.#.#.#...#
##.#...#...#.##.#..........###
##...#...#.#.##.##.#.#.#.#.#.#
##.#...#...#.##.#............#
##...#...#.#.$$.##.#.#.#.#.#.#
 ############################
		    ARTUR
		  "TUTORIAL"