	      _
	     | |
 #############_#######
#...#...........-+....#
#...#.................#####
#...#........$......../   #
#.###.................#####
#.....#.#.............[
#.....#Q#......Q#......#++++
#.....#.#.............()  +
#.....................#++++
 #...................#
  ###################