           ############################
          ##.#...##...######...#.......#
          ##...#..##.##...#..#...#..#.##
          ##.####..#.#..#.##...#...##.##
          ##.#####.....##....#...#.##.##
          ##.###########..#..########.##
          #>.............Q#Q...........[
          ##.###########..#..########.##
          ##.#######...##....#.#.#.##.##
          ##.#######.#.##.#.........#.##
          ##...#...#.#.##.##.#.#.#.#...#
          ##.#...#...#.##.#..........###
          ##...#...#.#.##.##.#.#.#.#.#.#
          ##.#...#...#.##.#............#
          ##...#...#.#....##.#.#.#.#.#.#
           ############################
                       ARTUR
                     "TUTORIAL"