                ##                    ##
             ###.#                    #.###
           ##...#  ###            ###  #..[##
          #]...#    #.#          #.#    #....#
         #....#     #.#          #.#     #....#
         #.##.#    #..#          #..#    #.##.#
        #.###..#  #..#            #..#  #..###.#
        #..##...##..#              #..##...##..#
         #.####....#                #....####.#
         #..##...##   ###      ###   ##...##..#
          #....##    #...#    #...#    ##....#
           #..#      #...#    #...#      #..#
           #..#     #..$..#  #..$..#     #..#
          #..#      #..$..#  #..$..#      #..#
          #..#       #...#    #...#       #..#
           #..#       #.#      #.#       #..#
            #..##   ###.########.###   ##..#
             #Q#####................####..#
              #..........................#
             #.....#......___......#.....#
            #......#.....{...}......#.....#
           ##.......#.....---......#.......##
          #..........###........###..........#
         #..##..........########..........##..#
        #..#  ##...####..........####...##  #..#
        #..#   #..#    ##########    #..#   #..#
         #.Q#   #..#                #..#   #..#
          ##     ##                  ##     ##
                         ARTIOM
        