 ##########################################################################################
 #Q.........#....................#.......#.............####......###.#......#.....#.......#
 ##########...#############.####...##.##.#.##.###..###..###.##.##..#...##.#...##.###.#.##.#
 #..#.....####............#.#####.#....#....#...##..###......#....#.#.#...#.#..#...#.#..#.#
 #.##.###.#....############.....##.###.##.#.###.###..###.#########....#.###.##.###...#.##.#
 #.#..#...#.####...........####....###...#....#...##...#.........####.#...#..#...#.###...##
 #...........................#....................##......................................#
 ##.#.#.....#####....#.....#.##.####.#..#.#..#.###..##....#..#..###.#.###....#.#####.#....#
 #..#..######...#.##..###.##.#####...#.#..##..#...#..##.#.#.#####.#.......#####...#..#.##.#
 #.###.#......##..#..####..#.##.#.########..#...##.###.#...###....#######.#....##.###.#...#
 #.....#.######.#.########.#......#.#.###..#####..#.....##...#.######...######.....#..#.###
 ###.###.#........#....#.#.########.#...##.####.#...####.###.....#..###.#....####.##.#....#
 #...##..#.####.###.##...#..........#.#.#....##.#..#..#....#.###...##....###....#....###.##
 #..........#............#..............#................................#................#
 #.#...##..##......#....##.#........#..####.#####.#..##.##.#.######.....##....#.#..###.##.#
 #...##...##..#.####.##.##.#.##.###.##.......#.....#....#..#.#..#...####...##.#..#...#...##
 ###.#...##..####....#...###.#..###..#######...###.###.#######.##.###.....#.#.##.###.#.#..#
 #...#.#.##.##....####.#...#...#######.....##.##.#.#.....#####.#....#.###.#..........#..###
 #.##..##...##.####..######..######.#..###.#.....#.#####.####...###.#...#.####.########..[#
 #.#..#.#.##...##.#.#.....#.##......##.#...#.###.#.###......###.##...####.#...#...#...#####
 #...##.#....##...#...###..#...#####...#####.# #.#.....###.##......##....##.#.#.#####.#..##
 #.###...###...#.##.###Q..#..####..##.##.....#########.###....####.#..##..#.#...#...#..#..#
 #.....#.....#.#.#..#.#####.###...#......#####.......#.######....########....####.#.#.##.##
 ###.###.#.#.#.#.#.##...#...###.#.#.##.#######.#####.#.#####.###.##......#######..#...#...#
 #]......#..#.........#...#.....#...##.........#.....#.........#....####.........#..#...#.#
 ##########################################################################################
 
                                          DENDI (easy) 